{
  "levels":[
    {
      "time":200,
      "map":[
        "0000000",
        "0000000",
        "0002000",
        "0021200",
        "0002000",
        "0000000",
        "0000000"
      ]
    } , {
      "time":250,
      "map":[
        "0000000",
        "0000000",
        "0001000",
        "0011100",
        "0001000",
        "0000000",
        "0000000"
      ]
    } , {
      "time":250,
      "map":[
        "0000000",
        "0001000",
        "0014100",
        "0141410",
        "0014100",
        "0001000",
        "0000000"
      ]
    } , {
      "time":250,
      "map":[
        "0000000",
        "0000000",
        "0001000",
        "0011100",
        "0001000",
        "0000000",
        "0000000"
      ]
    } , {
      "time":250,
      "map":[
        "0000000",
        "0000000",
        "0001000",
        "0011100",
        "0001000",
        "0000000",
        "0000000"
      ]
    } , {
      "time":250,
      "map":[
        "0000000",
        "0000000",
        "0012000",
        "0021100",
        "0001000",
        "0000000",
        "0000000"
      ]
    } , {
      "time":250,
      "map":[
        "0000000",
        "0000000",
        "0001000",
        "0011100",
        "0001000",
        "0000000",
        "0000000"
      ]
    } , {
      "time":250,
      "map":[
        "0000000",
        "0000000",
        "0001000",
        "0011100",
        "0001000",
        "0000000",
        "0000000"
      ]
    } , {
      "time":250,
      "map":[
        "0000000",
        "0000000",
        "0012000",
        "0021100",
        "0001000",
        "0000000",
        "0000000"
      ]
    } , {
      "time":250,
      "map":[
        "0000000",
        "0000000",
        "0001000",
        "0011100",
        "0001000",
        "0000000",
        "0000000"
      ]
    } , {
      "time":250,
      "map":[
        "0000000",
        "0000000",
        "0001000",
        "0011100",
        "0001000",
        "0000000",
        "0000000"
      ]
    } , {
      "time":250,
      "map":[
        "0000000",
        "0000000",
        "0012000",
        "0021100",
        "0001000",
        "0000000",
        "0000000"
      ]
    } , {
      "time":250,
      "map":[
        "0000000",
        "0000000",
        "0001000",
        "0011100",
        "0001000",
        "0000000",
        "0000000"
      ]
    } , {
      "time":250,
      "map":[
        "0000000",
        "0000000",
        "0001000",
        "0011100",
        "0001000",
        "0000000",
        "0000000"
      ]
    } , {
      "time":250,
      "map":[
        "0000000",
        "0000000",
        "0012000",
        "0021100",
        "0001000",
        "0000000",
        "0000000"
      ]
    } , {
      "time":250,
      "map":[
        "0000000",
        "0000000",
        "0001000",
        "0011100",
        "0001000",
        "0000000",
        "0000000"
      ]
    } , {
      "time":250,
      "map":[
        "0000000",
        "0000000",
        "0001000",
        "0011100",
        "0001000",
        "0000000",
        "0000000"
      ]
    } , {
      "time":250,
      "map":[
        "0000000",
        "0000000",
        "0012000",
        "0021100",
        "0001000",
        "0000000",
        "0000000"
      ]
    } , {
      "time":250,
      "map":[
        "0000000",
        "0000000",
        "0001000",
        "0011100",
        "0001000",
        "0000000",
        "0000000"
      ]
    } , {
      "time":250,
      "map":[
        "0000000",
        "0000000",
        "0001000",
        "0011100",
        "0001000",
        "0000000",
        "0000000"
      ]
    } , {
      "time":250,
      "map":[
        "0000000",
        "0000000",
        "0012000",
        "0021100",
        "0001000",
        "0000000",
        "0000000"
      ]
    } , {
      "time":250,
      "map":[
        "0000000",
        "0000000",
        "0001000",
        "0011100",
        "0001000",
        "0000000",
        "0000000"
      ]
    } , {
      "time":250,
      "map":[
        "0000000",
        "0000000",
        "0001000",
        "0011100",
        "0001000",
        "0000000",
        "0000000"
      ]
    } , {
      "time":250,
      "map":[
        "0000000",
        "0000000",
        "0012000",
        "0021100",
        "0001000",
        "0000000",
        "0000000"
      ]
    } , {
      "time":250,
      "map":[
        "0000000",
        "0000000",
        "0001000",
        "0011100",
        "0001000",
        "0000000",
        "0000000"
      ]
    }

  ]
}