0000000000
0000100000
0001210000
0001210000
0000100000
0000000000
:
0000000000
0000200000
0002320000
0002320000
0000200000
0000000000
:
0000000000
0000010000
0002334000
0002320000
0000203000
0000000000